[
    ["#","#","#","#","#","#","#","#","#","E"],
    ["S","S","S","S","M","S","S","S","S","M"],
    ["S","S","S","S","S","M","M","s","S","S"],
    ["S","S","S","S","S","S","W","M","M","S"],
    ["1","S","S","S","S","S","S","S","S","S"],
    ["M","S","S","S","2","S","S","S","S","S"],
    ["S","S","S","S","S","S","S","S","S","3"],
    ["M","S","S","S","S","S","S","S","S","S"],    
    ["W","M","M","M","S","S","S","S","S","S"],
    ["P","S","S","S","S","S","S","S","S","W"]    
]
