[
    ["#","#","#","#","#","#","#","#","#","E"],
    ["S","S","S","S","M","S","S","S","S","M"],
    ["S","S","S","S","S","M","M","s","S","S"],
    ["S","S","S","S","S","S","M","M","M","S"],
    ["1","S","S","S","S","S","S","S","S","S"],
    ["M","S","S","S","S","S","S","S","S","S"],
    ["S","S","S","S","S","S","S","S","S","1"],
    ["M","S","S","S","S","S","S","S","S","S"],    
    ["M","M","M","M","S","S","S","S","S","S"],
    ["P","S","S","S","S","S","S","S","S","M"]    
]
