[
    ["#","#","#","#","#","#","#","#","#","#","#","#","#","#","#","#","#","#","#","#"],
    ["S","S","S","S","M","S","S","S","S","S","S","S","S","S","S","S","S","S","S","S"],
    ["S","S","S","S","S","M","M","s","S","S","S","S","S","S","S","S","S","S","S","M"],
    ["S","S","S","S","S","S","M","M","M","S","S","S","S","S","S","S","S","S","S","S"],
    ["S","S","S","S","S","S","S","S","M","S","s","M","M","S","S","S","S","S","M","M"],
    ["M","S","S","S","S","S","S","S","S","S","S","S","M","M","S","M","S","S","S","S"],
    ["S","S","S","S","S","S","1","S","S","S","S","S","S","S","1","S","S","S","S","S"],
    ["M","S","S","S","S","S","S","S","S","S","S","S","S","M","M","S","S","S","S","S"],    
    ["M","M","M","M","S","S","S","S","S","S","S","S","S","S","M","M","S","S","S","S"],
    ["S","S","S","S","S","S","S","S","S","S","S","S","S","S","S","S","S","S","S","S"],
    ["S","S","S","S","S","S","S","S","S","S","S","S","S","S","S","S","S","S","S","S"],
    ["S","S","S","S","S","S","S","S","S","S","S","S","S","S","1","S","S","S","S","S"],
    ["M","M","S","M","M","S","S","S","S","S","S","S","S","S","S","S","M","S","M","M"],
    ["S","M","M","S","S","S","S","S","S","S","S","S","S","S","S","S","S","S","S","S"],
    ["S","S","S","S","S","M","M","M","S","S","S","S","S","S","S","S","S","S","S","M"],
    ["S","S","S","S","S","S","S","S","S","S","S","M","M","S","S","S","S","S","S","S"],
    ["S","S","S","S","S","S","S","S","S","S","M","M","M","M","S","S","S","S","M","M"],
    ["M","S","S","S","S","S","S","S","S","S","S","S","S","M","M","M","S","S","S","S"],
    ["S","S","S","S","1","S","S","S","S","S","S","S","S","S","S","S","S","S","S","S"],
    ["P","S","S","S","S","S","S","S","S","M","S","S","M","M","S","S","S","S","S","S"]    
]
